map(r(0 0 1 0 0 0 0 0 e 0 0 0 0)
	r(0 1 1 1 0 1 1 1 1 0 0 0 0)
	r(0 1 1 1 0 1 1 1 1 1 1 0 0)
	r(0 1 1 1 0 1 1 1 1 1 1 0 0)
	r(0 0 0 1 1 1 1 1 1 0 0 0 0)
	r(0 0 0 1 1 0 0 0 0 0 0 1 1)
	r(0 0 0 1 1 0 0 0 0 0 0 1 1)
	r(0 0 1 1 1 0 0 0 0 0 1 0 0)
	r(0 1 1 1 1 1 0 0 0 0 0 0 0)
	r(0 1 1 1 1 1 0 0 0 0 0 0 0)
	r(0 0 1 1 1 0 0 0 0 0 0 0 0)
	r(0 0 0 1 0 0 0 0 0 1 1 0 0)
	r(0 0 0 0 0 0 s 1 1 0 0 0 0))
